.........................
.........................
.........................
.........................
........_________........
......./.........\.......
......|...........|......
......|...........|......
.......\........./.......
.......;---------;.......
..../###############\....
./#####################\.
#########################
#########################