.........................
.........................
.........................
.........................
.........................
.........................
#_.......................
###_.................._##
####_......I...I...._####
#######_...^===^..._#####
########_..I.n.I.._######
#############^###########
#############$###########
#########################