.........................
.........................
.........................
.........................
.........................
.........................
......................._#
.................._######
........._##########.'..#
##^########......'......#
##^########^###_........#
##....n.....#..#_.n..$$$#
#########################
#########################