.........................
.........................
.........................
.........................
.........................
.........................
.........................
........./#######^.......
......../####'.##^.......
......./###$...'.^.......
..../########\.n.........
./################\......
#########################
#########################