.........................
.........................
.........................
.........................
.........................
.........................
.........................
.........................
.........................
...........n.............
#_......._###_........_##
#################^#######
###############0..#######
#########################