.........................
.........................
.........................
.........................
.........................
.........................
.........................
.........................
.........................
.............._#i#_......
......._#_._####i###_....
..._########.'.'i######_.
##########$.n...i########
#########################