.........................
.........................
.........................
.........................
.........................
.........................
......................._#
.................._######
........._##########.'..#
##i########......'......#
##i########i###_........#
##i...n....i#..#_.n..$$$#
#########################
#########################