.........................
.........................
.........................
.........................
.........................
.........................
.........................
.........................
.........................
...........n.............
#_......._###_........_##
#################i#######
###############0.i#######
#########################