.........................
.........................
.........................
.........................
.........................
.........................
.........................
.........................
.........................
.............._#^#_......
......._#_._####^###_....
..._########.'.'^######_.
##########$.n....########
#########################