.........................
.........................
.........................
.........................
.........................
.........................
.........................
........._#######i.......
........_####'.##i.......
......._###$...'.i.......
...._########_.n.i.......
._################_......
#########################
#########################