.........................
.........................
.........................
.........................
.........................
.........................
.........................
.........................
.........................
...........n.............
#_......._###_...0...._##
#########################
#########################
#########################