.........................
.........................
.........................
.........................
.........................
.........................
.........................
........._#######^.......
........_####'.##^.......
......._###$...'.^.......
...._########_.n.........
._################_......
#########################
#########################