.........................
.........................
.........................
.........................
.........................
.........................
.........................
.........................
.........................
...........n.............
#\......./###\...R..../##
#########################
#########################
#########################