.........................
.........................
.........................
.........................
.........................
.........................
......................./#
................../######
........./##########.'..#
##^########......'......#
##^########^###\........#
##....n.....#..#\.n..$$$#
#########################
#########################