.........................
.........................
.........................
.........................
.........................
.........................
.........................
.........................
.........................
............../#^#\......
......./#\./####^###\....
.../########.'.'^######\.
##########$.n....########
#########################