.........................
.........................
.........................
.........................
.........................
.........................
#\.......................
###\................../##
####\......I...I..../####
#######\...^===^.../#####
########\..I.n.I../######
#############^###########
#############$###########
#########################