.........................
.........................
.........................
.........................
.........................
.......||||||^||||||.....
.......eS.S.S-S.S.Se.....
.......v|||||||||||v.....
.......eS.S.S.S.S.Se.....
....e./|||||||||||||\.e..
....v|+++++++++++++++|v..
....v|||||||||||||||||v..
....eISWIsS.IOI.SgIbSIe..
####|||||||||||||||||||##
#########################