.........................
.........................
.........................
.........................
.........................
.........................
......./||||\............
.......|AAAA|............
....../|^||||\...........
......[O-BbgB]...........
......|^|||||||||........
......<F.DKLb>GG>........
######|||||||||||########
#########################