.........................
.........................
.........................
.........................
.........||v|||..........
.........[Bebg]..........
.........||v|||..........
.........[OebB]..........
.........||v|||..........
.........[BebB]..........
.........||v|||..........
.........<LeKL>..........
#########||||||##########
#########################