.........................
.........................
.........................
.........................
.........................
.........................
.........................
.........................
............3............
......./|||||||||\.......
...._###############_....
._#####################_.
#########################
#########################