.........................
.........................
.........................
.........................
.........................
.........................
.........................
.........................
............3............
......./|||||||||\.......
..../###############\....
./#####################\.
#########################
#########################