.........................
.........................
.........................
.........................
.........................
.........................
.........................
.........................
............5............
......./|||||||||\.......
..../###############\....
./#####################\.
#########################
#########################