.........................
.........................
.........................
.........................
.........................
.........................
.........................
.........................
............6............
......./|||||||||\.......
...._###############_....
._#####################_.
#########################
#########################