.........................
.........................
.........................
.........................
.........................
.........................
.........................
.........................
............6............
......./|||||||||\.......
..../###############\....
./#####################\.
#########################
#########################