.........................
.........................
.........................
.........................
........|||||||||........
......./.........\.......
......|...........|......
......|...........|......
.......\........./.......
.......;|||||||||;.......
..../###############\....
./#####################\.
#########################
#########################