.........................
.........................
.........................
.........................
.........................
.........................
.........................
.........................
............7............
......./|||||||||\.......
..../###############\....
./#####################\.
#########################
#########################