.........................
.........................
.........................
.........................
.........................
.........................
.........................
.........................
............5............
......./|||||||||\.......
...._###############_....
._#####################_.
#########################
#########################