.........................
.........................
.........................
.........................
.........................
.........................
.........................
.........................
............4............
......./|||||||||\.......
..../###############\....
./#####################\.
#########################
#########################