.........................
.........................
.........................
.........................
.........................
.........................
.........................
.........................
............4............
......./|||||||||\.......
...._###############_....
._#####################_.
#########################
#########################