.........................
.........................
.........................
.........................
.........................
.........................
.........................
.........................
............7............
......./|||||||||\.......
...._###############_....
._#####################_.
#########################
#########################