.........................
.........................
.........................
.........................
.........................
.........................
.........................
.........................
.........................
........../|||\..........
........./|||||\.........
..........[KBb]..........
......../|||||||\........
..........|||||..........
..........|||||..........
..........|||||..........
..........|||||..........
..........|||||..........
..........|||||..........
..........|||||..........
..........|||||..........
..........|||||..........
..........|||||..........
..........|||||..........
..........|||||..........
..........|||||..........
#########################
#########################