.........................
.........................
.........................
.........................
.........................
.......=============.....
........S-S-S-S-S-S......
.......^===========^.....
........S-S-S-S-S-S......
....../=============\....
....^=+++++++++++++++=^..
....^\===============/^..
....I-SWIsS-IOI-SgIbS-I..
#########################
#########################