.........................
.........................
.........................
.........................
........../^\............
.........|AAA|...........
......../=====\..........
......./[b-BWB]\.........
........|=^===|..........
........[b-BOB]..........
........|=^===|=\........
........<F-LDK>G>........
##########^##############
#########CCC#############
#########################
#########################
#########################