.........................
.........................
.........................
.........................
.........................
.........................
......./====\............
.......|AAAA|............
....../|^===|\...........
...../[O-BbgB]\..........
......|=^====|===........
......<F-DKLL>GG>........
#########################
#########################