.........................
.........................
.........................
.........................
.........|=^==|..........
.........[B-bg]..........
.........|==^=|..........
.........[Ob-B]..........
.........|=^==|..........
.........[B-bB]..........
.........|==^=|..........
.........<LKDL>..........
#########################
#########################