{
    "outside_1": {
        "map_name": "outside_1",
        "map_tiles": [
            "........................",
            "........................",
            "........................",
            "........................",
            "........................",
            "........................",
            "........................",
            "........_########i......",
            "......._#####'.##i......",
            "......_###$....'.i......",
            "...._#######_....i......",
            "._################_.....",
            "########################",
            "########################"
        ],
        "creator": "ebolite"
    },
    "outside_2": {
        "map_name": "outside_2",
        "map_tiles": [
            "........................",
            "........................",
            "........................",
            "........................",
            "........................",
            "........................",
            "........................",
            "........................",
            "........................",
            "............._#i#_......",
            "......_#_._####i###_....",
            "..._#######''.'i######_.",
            "#########$.n...i########",
            "########################"
        ],
        "creator": "ebolite"
    },
    "outside_3": {
        "map_name": "outside_3",
        "map_tiles": [
            "........................",
            "........................",
            "........................",
            "........................",
            "........................",
            "........................",
            "......................_#",
            "................._######",
            "........_##########''.'#",
            "##i#######......'......#",
            "##i######'i###_........#",
            "##i...n...i####_.n..$$$#",
            "########################",
            "########################"
        ],
        "creator": "ebolite"
    },
    "outside_4": {
        "map_name": "outside_4",
        "map_tiles": [
            "........................",
            "........................",
            "........................",
            "........................",
            "........................",
            "........................",
            "........................",
            "........................",
            "........................",
            "..........n.............",
            "#_......_###_........_##",
            "################i#######",
            "##############0.i#######",
            "########################"
        ],
        "creator": "ebolite"
    },
    "outside_5": {
        "map_name": "outside_5",
        "map_tiles": [
            "........................",
            "........................",
            "........................",
            "........................",
            "........................",
            "........................",
            "#_........I.0.I.........",
            "###_......I.^.I......_##",
            "####_.....I/|\\I...._####",
            "#######_..^|||^..._#####",
            "########_.I.n.I.._######",
            "##########||^||#########",
            "###########|-$|#########",
            "###########||||#########"
        ],
        "creator": "ebolite"
    }
}