{
    "outside_1": {
        "map_name": "outside_1",
        "map_tiles": [
            "........................",
            "........................",
            "........................",
            "........................",
            "........................",
            "........................",
            "........................",
            "........_########i......",
            "......._#####'.##i......",
            "......_###%....'.i......",
            "...._#######_....i......",
            "._################_.....",
            "########################",
            "########################"
        ],
        "creator": "ebolite"
    },
    "outside_2": {
        "map_name": "outside_2",
        "map_tiles": [
            "........................",
            "........................",
            "........................",
            "........................",
            "........................",
            "........................",
            "........................",
            "........................",
            "........................",
            "............._#i#_......",
            "......_#_._####i###_....",
            "..._#######''.'i######_.",
            "#########%.n...i########",
            "########################"
        ],
        "creator": "ebolite"
    },
    "outside_3": {
        "map_name": "outside_3",
        "map_tiles": [
            "........................",
            "........................",
            "........................",
            "........................",
            "........................",
            "........................",
            "......................_#",
            "................._######",
            "........_##########''.'#",
            "##i#######......'......#",
            "##i######'i###_........#",
            "##i...n...i####_.n..%%%#",
            "########################",
            "########################"
        ],
        "creator": "ebolite"
    },
    "outside_4": {
        "map_name": "outside_4",
        "map_tiles": [
            "........................",
            "........................",
            "........................",
            "........................",
            "........................",
            "........................",
            "........................",
            "........................",
            "........................",
            "..........n.............",
            "#_......_###_........_##",
            "################i#######",
            "##############0.i#######",
            "########################"
        ],
        "creator": "ebolite"
    },
    "outside_5": {
        "map_name": "outside_5",
        "map_tiles": [
            "........................",
            "........................",
            "........................",
            "........................",
            "........................",
            "........................",
            "#_........I.0.I.........",
            "###_......I.^.I......_##",
            "####_.....I/|\\I...._####",
            "#######_..^|||^..._#####",
            "########_.I.n.I.._######",
            "##########||^||#########",
            "###########|-&|#########",
            "###########||||#########"
        ],
        "creator": "ebolite"
    },
    "mini_dungeon_1": {
        "map_name": "mini_dungeon_1",
        "map_tiles": [
            "........................",
            "........................",
            "........................",
            "........................",
            "........................",
            "........................",
            "........................",
            "........................",
            "........................",
            "........................",
            "................._###_..",
            "####_.._###_..._########",
            "#############i##########",
            "#########||||i|#########",
            "########||..Ii|''.'#####",
            "##|||||||..nIi.....#####",
            "##|.I..I|i|||||\\...'..%#",
            "##|.I..I.i|######_..._##",
            "##|\\I%%I/||#######i#####",
            "###||||||||#######i'####",
            "##|||||..I|#'.....i...##",
            "##|0.....I....n...i.#i##",
            "##|||\\n$nI_#''''''###i##",
            "####|||||||#......###i##",
            "############_.....'..i##",
            "#############.n.n..i####",
            "##################_i..##",
            "####################_&##",
            "########################"
        ],
        "creator": "ebolite"
    },
    "cliff_thing": {
        "map_name": "cliff_thing",
        "map_tiles": [
            "........................",
            "........................",
            "........................",
            "........................",
            "........................",
            "........................",
            "........................",
            ".............._###......",
            "............._##''......",
            "........n%._###&n.......",
            "......_##########_......",
            "..._###############_....",
            "########################",
            "########################"
        ],
        "creator": "ebolite"
    },
    "terrain_structure": {
        "map_name": "terrain_structure",
        "map_tiles": [
            "........................",
            "........................",
            "......i####_...n&.......",
            "......i.I'########......",
            "......i.I........I......",
            "....._#_I........I......",
            "....#######_.....I......",
            "....'''######i####......",
            ".......I.....i..'#......",
            ".......I...n.i...I......",
            ".......I.._###_..I......",
            "......_########_.I......",
            "########################",
            "########################"
        ],
        "creator": "ebolite"
    },
    "hilly": {
        "map_name": "hilly",
        "map_tiles": [
            "............................................",
            "............................................",
            "............................................",
            "............................................",
            "....................................._#_....",
            "...................................._####_..",
            "..................................._######_.",
            ".................................._#########",
            "................._###i###i.....i############",
            "......._###_...._##''i###i.....i############",
            "....._######_._##%%%.i####_n&n_#############",
            "############################################",
            "############################################",
            "############################################"
        ],
        "creator": "ebolite"
    }
}