.........................
.........................
.......###^###^..........
..........^...^..........
..........^..............
..........^...#######....
.........................
###\.../###...../^\......
....\./......../===|====.
.....X......../[B-B]..I..
..../.\....../.|=^=|..I..
.../...\..../..>D-L<..I..
#########################
#########################